111111111
100000001
10C000E01
100000001
10000P001
100000001
100000001
100000001
100000001
100000001
100000001
100000001
111111111