111111111111
1CCC10001111
100010E01111
10P010111111
100000001111
111111111111