111111111111
100010001111
10C010E01111
1CCC10111111
10000P001111
111111111111